10,10,1
#dimension
0,4,0,0xff0000
0,5,0,0xff0000
1,3,0,0xff0000
1,4,0,0xff0000
1,5,0,0xff0000
1,6,0,0xff0000
2,2,0,0xff0000
2,3,0,0xff0000
2,4,0,0xff0000
2,5,0,0xff0000
2,6,0,0xff0000
2,7,0,0xff0000
3,1,0,0xff0000
3,2,0,0xff0000
3,3,0,0xff0000
3,4,0,0xff0000
3,5,0,0xff0000
3,6,0,0xff0000
3,7,0,0xff0000
3,8,0,0xff0000
4,0,0,0xff0000
4,1,0,0xff0000
4,2,0,0xff0000
4,3,0,0xff0000
4,4,0,0xff0000
4,5,0,0xff0000
4,6,0,0xff0000
4,7,0,0xff0000
4,8,0,0xff0000
4,9,0,0xff0000
5,0,0,0xff0000
5,1,0,0xff0000
5,2,0,0xff0000
5,3,0,0xff0000
5,4,0,0xff0000
5,5,0,0xff0000
5,6,0,0xff0000
5,7,0,0xff0000
5,8,0,0xff0000
5,9,0,0xff0000
6,1,0,0xff0000
6,2,0,0xff0000
6,3,0,0xff0000
6,4,0,0xff0000
6,5,0,0xff0000
6,6,0,0xff0000
6,7,0,0xff0000
6,8,0,0xff0000
7,2,0,0xff0000
7,3,0,0xff0000
7,4,0,0xff0000
7,5,0,0xff0000
7,6,0,0xff0000
7,7,0,0xff0000
8,3,0,0xff0000
8,4,0,0xff0000
8,5,0,0xff0000
8,6,0,0xff0000
9,4,0,0xff0000
9,5,0,0xff0000
#solution
0,0,2,0
1,0,4,0
2,0,6,0
3,0,8,0
4,0,10,0
5,0,10,0
6,0,8,0
7,0,6,0
8,0,4,0
9,0,2,0
#hint x
0,0,2,0
1,0,4,0
2,0,6,0
3,0,8,0
4,0,10,0
5,0,10,0
6,0,8,0
7,0,6,0
8,0,4,0
9,0,2,0
#hint y
#hint z