3,9,3
#dimension
0,4,1,0x000000
0,5,0,0x000000
0,5,1,0x000000
0,5,2,0x000000
0,6,0,0x000000
0,6,1,0x000000
0,6,2,0x000000
0,7,1,0x000000
1,0,1,0x000000
1,1,1,0x000000
1,3,1,0x000000
1,4,0,0x000000
1,4,1,0x000000
1,4,2,0x000000
1,5,0,0x000000
1,5,1,0x000000
1,5,2,0x000000
1,6,0,0x000000
1,6,1,0x000000
1,6,2,0x000000
1,7,0,0x000000
1,7,1,0x000000
1,7,2,0x000000
1,8,1,0x000000
2,4,1,0x000000
2,5,0,0x000000
2,5,1,0x000000
2,5,2,0x000000
2,6,0,0x000000
2,6,1,0x000000
2,6,2,0x000000
2,7,1,0x000000
#solution
1,1,1,0
3,1,1,0
4,0,1,0
4,1,3,0
4,2,1,0
5,0,3,0
5,1,3,0
5,2,3,0
6,1,3,0
7,1,3,0
#hint x
0,0,2,0
0,1,4,0
0,2,2,0
1,0,4,0
1,1,8,1
1,2,4,0
2,0,2,0
2,1,4,0
2,2,2,0
#hint y
1,3,1,0
1,8,1,0
#hint z