5,5,1
#dimension
0,0,0,0x000000
0,1,0,0x000000
0,2,0,0x000000
0,3,0,0x000000
0,4,0,0x000000
1,0,0,0x000000
1,2,0,0x000000
1,4,0,0x000000
2,0,0,0x000000
2,2,0,0x000000
2,4,0,0x000000
3,0,0,0x000000
3,2,0,0x000000
3,4,0,0x000000
4,0,0,0x000000
4,4,0,0x000000
#solution
4,0,5,0
#hint x
0,0,5,0
1,0,3,2
2,0,3,2
3,0,3,2
4,0,2,1
#hint y
4,1,0,0
4,2,0,0
4,3,0,0
#hint z