5,5,1
#dimension
0,0,0,0x000000
0,1,0,0x000000
0,2,0,0x000000
0,3,0,0x000000
0,4,0,0x000000
1,2,0,0x000000
2,2,0,0x000000
3,2,0,0x000000
4,0,0,0x000000
4,1,0,0x000000
4,2,0,0x000000
4,3,0,0x000000
4,4,0,0x000000
#solution
2,0,5,0
#hint x
0,0,5,0
1,0,1,0
2,0,1,0
3,0,1,0
#hint y
#hint z